%%%%%%%%%%%%%%%%%%%%
%......%G  G%......%
%.%%%..%%  %%..%%%.%
%. o%%........%%o .%
%.%%%%.%%%%%%.%%%%.%
%.....oo.P.oo......%
%       %%%        %
%%%%%%%%%%%%%%%%%%%%